17,18,19,19,19,19,19,19,19,19,19,19,19,19,19,19,19,19,19,19,19,19,19,19,19,19,19,19,19,19,17,19,19,19,19,17,19,19,19,19,19,19,19,19,19,19,19,19,19,19,19,19,19,19,19,19,19,19,20,17
34,71,71,71,71,71,71,71,71,71,71,71,71,71,71,71,71,71,71,71,71,71,71,71,71,71,71,71,71,71,34,71,71,124,138,34,138,71,71,71,71,71,71,71,71,71,71,71,71,71,71,71,71,71,71,71,71,71,71,34
51,71,71,71,71,71,71,71,71,71,71,71,71,71,71,71,71,71,71,71,71,71,71,71,71,71,71,71,71,71,51,122,123,122,123,51,71,71,71,71,71,71,71,71,71,71,71,71,71,71,71,71,71,71,71,71,71,71,71,51
51,71,71,71,71,71,71,71,71,71,71,71,71,71,71,71,71,71,71,71,71,71,71,71,71,71,71,71,71,71,68,139,140,139,140,51,71,71,71,71,71,71,71,71,71,71,71,71,71,71,71,71,71,71,71,71,71,71,71,51
51,71,71,71,71,71,71,71,71,71,71,71,71,71,71,71,71,71,71,71,71,122,123,122,123,71,71,71,71,71,17,71,71,71,71,51,71,71,71,71,71,71,71,71,71,71,71,71,71,71,71,71,71,71,71,71,71,71,71,51
51,71,71,71,71,17,18,19,19,19,19,19,19,19,19,19,19,19,19,20,17,139,140,139,140,17,71,71,71,71,71,71,71,71,71,51,71,71,71,71,71,71,71,71,71,71,71,71,17,18,19,19,19,20,17,71,71,71,71,51
51,122,123,122,123,34,71,71,71,71,71,71,71,71,71,71,71,71,71,71,71,71,71,71,71,34,71,71,71,71,71,71,71,71,71,51,71,71,71,71,71,71,71,71,71,71,71,71,34,138,71,71,71,71,71,71,71,71,71,51
51,139,140,139,140,51,71,71,71,71,71,71,71,71,71,71,71,71,71,71,71,71,71,71,71,51,71,71,71,71,71,71,71,71,71,51,71,71,71,71,71,71,71,71,71,71,71,71,51,71,71,71,71,71,71,71,71,71,71,51
51,71,71,71,71,51,71,71,71,71,71,71,71,71,71,71,71,71,71,71,71,71,71,71,71,51,71,71,71,71,71,71,71,71,71,51,71,71,71,71,71,71,71,71,71,71,71,71,51,71,71,71,71,71,71,71,71,71,71,51
51,71,71,71,71,51,71,71,71,71,71,71,71,71,71,71,71,71,71,71,71,71,71,71,71,51,71,71,71,71,71,71,71,71,71,51,71,71,71,71,71,71,71,71,71,71,71,71,51,71,71,71,71,71,71,71,71,71,71,51
51,71,71,71,71,51,122,123,71,122,123,71,71,71,71,71,71,71,71,71,71,71,71,71,71,68,71,71,71,71,71,71,71,71,71,68,71,71,71,71,71,71,71,71,71,71,71,71,68,71,71,71,71,71,71,71,71,71,71,51
51,71,71,71,71,51,139,140,71,139,140,17,18,19,20,17,19,19,19,19,19,19,19,19,19,17,19,19,19,19,19,19,19,19,19,17,71,71,71,71,17,18,19,19,19,19,19,20,17,71,71,71,71,71,71,71,71,71,138,68
51,122,123,122,123,51,71,122,123,71,122,123,120,124,138,51,71,71,71,122,123,71,71,71,71,71,71,71,71,71,71,71,71,71,71,71,71,71,71,71,34,138,124,120,71,71,71,71,34,71,71,71,71,71,17,18,19,19,20,17
51,139,140,139,140,51,71,139,140,71,139,140,120,120,120,51,71,71,71,139,140,71,71,71,71,71,71,71,71,71,71,71,71,71,71,71,71,71,71,71,51,120,120,120,71,71,71,71,51,71,71,71,71,71,71,71,71,71,71,34
51,71,71,71,71,51,71,71,71,71,71,71,71,71,71,51,71,71,71,122,123,71,71,71,71,71,71,71,71,71,71,71,71,71,71,71,71,71,71,71,51,71,71,71,71,71,71,71,51,71,71,71,71,71,71,71,71,71,71,51
51,71,71,71,71,51,71,71,71,71,71,71,71,71,71,51,121,121,71,139,140,71,71,71,71,71,71,71,71,71,71,71,71,71,71,71,71,71,71,71,51,71,71,71,71,71,71,71,51,71,71,71,71,71,71,71,71,71,71,51
51,71,71,71,71,51,71,71,71,71,71,71,71,71,71,51,124,121,71,122,123,71,71,71,71,71,71,71,71,71,71,71,71,71,71,71,71,71,71,71,51,71,71,71,71,71,71,71,51,71,71,71,71,71,71,71,71,71,71,51
51,71,71,71,71,51,71,71,71,71,71,71,71,71,71,51,138,121,71,139,140,71,71,71,71,71,71,71,71,71,122,123,122,123,71,71,71,71,71,71,68,71,71,71,71,71,71,71,68,71,71,71,71,71,71,71,71,71,71,51
51,122,123,122,123,68,71,71,71,71,71,71,71,71,71,17,19,19,19,19,20,17,18,19,19,19,19,19,20,17,139,140,139,140,17,18,19,19,19,20,17,71,71,71,71,71,71,71,17,71,71,71,71,71,17,71,71,71,71,51
51,139,140,139,140,17,18,19,19,20,17,71,71,71,71,71,71,71,71,71,71,34,71,71,71,71,71,71,71,71,71,71,71,71,71,71,71,71,71,71,34,71,71,71,71,71,71,71,71,71,71,71,71,71,34,71,71,71,71,51
51,71,71,71,71,71,71,71,71,71,34,71,71,71,71,71,71,71,71,71,71,51,71,71,71,71,71,71,71,71,71,71,71,71,71,71,71,71,71,71,51,71,71,71,71,71,71,71,71,71,71,71,71,71,51,71,71,71,71,51
51,71,71,71,71,71,71,71,71,71,51,71,71,71,71,71,71,71,71,71,71,51,71,71,71,71,71,71,71,71,71,71,71,71,71,71,71,71,71,71,51,71,71,71,71,71,71,71,71,71,71,71,71,71,51,71,71,71,71,51
51,71,71,71,71,71,71,71,71,71,51,71,71,71,71,71,71,71,71,71,71,51,71,71,71,71,71,71,71,71,71,71,71,71,71,71,71,71,120,120,51,71,71,71,71,71,71,71,71,71,71,71,71,71,51,71,71,71,71,51
51,71,71,71,71,71,71,71,71,71,51,71,71,71,71,71,71,71,71,71,71,51,71,71,71,71,71,71,71,71,71,71,71,71,71,71,71,71,120,138,68,71,71,71,71,71,71,71,71,71,71,71,71,71,68,71,71,71,71,51
68,71,71,71,71,71,122,123,122,123,68,71,71,71,71,71,71,71,71,71,71,51,71,71,71,71,71,71,71,17,19,19,19,19,19,19,19,19,19,19,17,71,71,71,71,17,18,19,19,19,19,19,19,20,17,71,71,71,71,51
17,18,19,19,20,17,139,140,139,140,17,18,19,19,17,71,71,71,71,71,71,51,71,71,71,71,71,71,71,34,71,71,71,71,71,71,71,120,138,138,34,71,71,71,71,71,71,71,71,71,71,71,71,71,34,71,71,71,71,51
34,71,71,71,71,34,122,123,122,123,71,71,96,97,34,71,71,71,71,71,71,68,71,71,71,71,71,71,71,51,71,71,71,71,71,71,71,120,120,120,51,71,71,71,71,71,71,71,71,71,71,71,71,71,51,71,71,71,71,51
51,71,71,71,71,51,139,140,139,140,71,71,113,114,51,71,71,71,71,71,71,17,71,71,71,71,71,71,71,51,71,71,71,71,71,71,71,71,71,71,51,71,71,71,71,71,71,71,71,71,71,71,71,71,51,122,123,122,123,51
51,71,71,71,71,51,71,71,71,71,71,71,71,125,51,71,71,71,71,71,71,71,71,71,71,71,71,71,71,51,71,71,71,71,71,71,71,71,71,71,51,71,71,71,71,71,71,71,71,71,71,71,71,71,51,139,140,139,140,51
51,71,71,71,71,51,71,71,71,71,71,71,96,97,51,71,71,71,71,71,71,71,71,71,71,71,120,120,120,51,71,71,71,71,71,71,71,71,71,71,51,71,71,71,71,71,71,71,71,71,71,71,71,71,51,71,138,138,71,51
51,71,71,71,71,68,71,71,71,71,71,71,113,114,68,71,71,71,71,71,71,71,71,71,71,71,120,138,138,68,71,71,71,71,71,71,71,71,71,71,51,71,71,71,71,71,71,71,71,71,71,71,71,71,68,138,138,138,138,51
51,71,71,71,71,17,18,19,19,19,19,19,19,20,17,19,19,19,19,19,19,19,19,19,19,19,19,19,19,17,71,71,71,71,71,17,71,71,71,71,51,71,71,71,71,71,71,71,17,71,71,71,71,71,17,18,19,19,20,17
51,71,71,71,71,71,71,71,71,71,71,71,71,71,71,71,71,71,71,71,71,71,71,71,71,71,71,71,71,71,71,71,71,71,71,34,71,71,71,71,51,71,71,71,71,71,71,71,34,71,71,71,71,71,71,71,71,71,71,51
51,71,71,71,71,71,71,71,71,71,71,71,71,71,71,71,71,71,71,71,71,71,71,71,71,71,71,71,71,71,71,71,71,71,71,51,71,71,71,71,51,71,71,71,71,71,71,71,51,71,71,71,71,71,71,71,71,71,71,51
51,71,71,71,71,71,71,71,71,71,71,71,71,71,71,71,71,71,71,71,71,71,71,71,71,71,71,71,71,71,71,71,71,71,71,51,71,71,71,71,51,71,71,71,71,71,71,71,51,71,71,71,71,71,71,71,71,71,71,51
51,71,71,71,71,71,71,71,71,71,71,71,71,71,71,71,71,71,71,71,71,71,71,71,71,71,71,71,71,71,71,71,71,71,71,51,71,71,71,71,51,71,71,71,71,71,71,71,51,71,71,71,71,71,71,71,71,71,71,51
51,71,71,71,71,71,71,71,71,71,71,71,71,71,71,71,71,71,71,71,71,71,71,71,71,71,71,71,71,71,71,71,71,71,71,68,71,71,71,71,68,71,71,71,71,71,71,71,68,71,71,71,71,71,71,71,71,71,71,51
51,71,71,71,71,17,18,19,19,19,20,17,71,71,71,71,71,17,18,19,19,19,19,19,19,19,19,19,19,19,19,19,19,19,20,17,71,71,71,71,17,19,19,19,19,19,19,20,17,18,19,19,19,19,17,71,71,71,71,51
51,71,71,71,71,122,123,71,71,71,71,34,71,71,71,71,71,71,71,71,71,71,71,71,71,71,71,71,71,71,71,71,71,71,124,34,71,71,71,71,71,71,71,71,71,71,71,71,71,71,71,71,71,71,71,71,71,71,71,51
51,71,71,71,71,139,140,71,71,71,71,51,71,71,71,71,71,71,71,71,71,71,71,71,71,71,71,71,71,71,71,71,71,71,71,51,71,71,71,71,71,71,71,71,71,71,71,71,71,71,71,71,71,71,71,71,71,71,71,51
51,71,71,71,71,122,123,71,71,71,124,51,71,71,71,71,71,71,71,71,71,71,71,71,71,71,71,71,71,71,71,71,71,71,71,51,71,71,71,71,71,71,71,71,71,71,71,71,71,71,71,71,71,71,71,71,71,71,71,51
68,71,71,71,71,139,140,71,71,71,138,68,71,71,71,71,71,71,71,71,71,71,71,71,71,71,71,71,71,71,71,71,71,71,71,68,71,71,71,71,71,71,71,71,71,71,71,71,71,71,71,71,71,71,71,71,71,71,71,51
17,18,19,19,19,19,19,19,19,19,20,17,18,19,19,19,19,19,20,17,71,71,71,71,17,18,19,19,19,17,71,71,71,71,71,17,19,19,19,19,19,19,19,19,19,19,19,20,17,71,71,71,71,71,17,19,19,19,20,17
34,71,71,71,71,71,71,71,71,71,71,71,71,71,71,71,71,71,71,71,71,71,71,71,34,138,138,138,138,34,71,71,71,71,71,34,138,120,71,71,71,71,71,71,71,71,71,138,34,71,71,71,71,71,34,71,124,138,138,51
51,71,71,71,71,71,71,71,71,71,71,71,71,71,71,71,71,71,71,71,71,71,71,71,51,138,124,124,138,51,71,71,71,71,71,51,120,120,71,71,71,71,71,71,71,71,71,71,51,71,71,71,71,71,51,121,121,121,121,51
51,71,71,71,71,71,71,71,71,71,71,71,71,71,71,71,71,71,71,71,71,71,71,71,51,120,120,120,120,51,71,71,71,71,71,51,71,71,71,71,71,71,71,71,71,71,71,71,51,71,71,71,71,71,51,122,123,122,123,51
51,71,71,71,71,71,71,71,71,71,71,71,71,71,71,71,71,71,71,71,71,71,71,71,51,120,120,120,120,51,71,71,71,71,71,51,71,71,71,71,71,71,71,71,71,71,71,71,51,71,71,71,71,71,51,139,140,139,140,51
51,71,71,71,71,71,71,71,71,71,71,71,71,71,71,71,71,71,71,71,71,71,71,71,68,122,123,122,123,51,71,71,71,71,71,51,71,71,71,71,71,71,71,71,71,71,71,71,51,71,71,71,71,71,51,71,71,71,71,51
51,122,123,122,123,17,18,19,19,19,19,19,19,19,19,19,19,19,20,17,18,19,19,19,19,139,140,139,140,51,71,71,71,71,71,68,71,71,71,71,71,71,71,71,71,71,71,71,51,71,71,71,71,71,51,71,71,71,71,51
51,139,140,139,140,34,71,71,71,71,71,71,71,71,71,71,71,71,71,34,71,71,71,71,71,122,123,122,123,51,71,71,71,71,71,17,18,19,19,19,19,19,20,17,71,71,71,71,51,71,71,71,71,71,51,71,71,71,71,51
51,71,71,71,71,51,71,71,71,71,71,71,71,71,71,71,71,71,71,51,71,71,71,71,71,139,140,139,140,51,71,71,71,71,71,122,123,71,71,71,71,71,71,71,71,71,71,71,51,71,71,71,71,71,51,71,71,71,71,51
51,71,71,71,71,51,71,71,71,71,71,71,71,71,71,71,71,71,71,51,71,71,71,71,71,71,71,71,71,51,71,71,71,71,71,139,140,71,71,71,71,71,71,71,71,71,71,71,51,71,71,71,71,71,51,71,71,71,71,51
51,122,123,122,123,51,122,123,122,123,71,71,71,71,71,71,71,71,71,51,71,71,71,71,71,71,71,71,71,51,71,71,71,71,71,122,123,71,71,71,71,71,71,71,71,71,71,71,51,71,71,71,71,71,51,71,71,71,71,51
51,139,140,139,140,51,139,140,139,140,71,71,71,71,71,71,71,71,71,68,122,123,122,123,71,71,71,71,71,68,71,71,71,71,71,139,140,71,71,71,71,71,71,71,71,71,71,71,51,71,71,71,71,71,68,71,71,71,71,51
51,71,71,71,71,68,71,71,71,71,71,17,71,71,71,71,71,71,71,17,139,140,139,140,17,18,19,19,20,17,18,19,19,19,19,19,19,19,19,19,19,19,20,17,71,71,71,71,51,71,71,71,71,71,17,71,71,71,71,51
51,71,71,71,71,71,71,71,71,71,71,34,122,123,122,123,122,123,122,123,71,71,71,71,71,71,71,71,71,34,71,71,71,71,71,71,122,123,71,71,124,71,71,71,71,71,71,71,51,71,71,71,71,71,71,71,71,71,71,51
51,71,71,71,71,71,71,71,71,71,71,51,139,140,139,140,139,140,139,140,71,71,71,71,71,71,71,71,71,51,71,71,71,71,71,71,139,140,71,71,71,71,71,71,71,71,71,71,51,71,71,71,71,71,71,71,71,71,71,51
51,71,71,71,71,71,71,71,71,71,71,51,71,71,71,71,71,71,71,71,71,71,71,71,71,71,71,71,71,51,71,71,71,71,71,71,122,123,71,71,71,71,71,71,71,71,71,71,51,71,71,71,71,71,71,71,71,71,71,51
68,71,71,71,71,71,71,71,71,71,71,68,138,138,124,71,71,71,71,71,71,71,71,71,71,71,71,71,71,68,71,89,90,91,92,71,139,140,71,71,71,71,71,71,71,71,71,138,68,138,138,71,71,71,71,71,71,71,71,68
17,18,19,19,19,19,19,19,19,19,20,17,18,19,19,19,19,19,19,19,19,19,19,19,19,19,19,19,20,17,71,106,107,108,109,71,17,18,19,19,19,19,19,19,19,19,19,20,17,18,19,19,19,19,19,19,19,19,19,17
