//13, 2, 3, 4, 5, 6, 7, 8, 9, 1313, 1313, 132, 133, 134, 135, 136, 137, 138, 139, 213, 213, 22, 23, 24, 25, 26, 27, 28, 29, 313, 313, 32
3, 0, 13, 0, 13, 0, 13, 0, 13, 0, 13, 0, 13, 0, 13, 0, 13, 0, 13, 0, 13, 0, 13, 0, 13, 0, 13, 0, 13, 0, 13, 0
0, 13, 0, 13, 0, 13, 0, 13, 0, 13, 0, 13, 0, 13, 0, 13, 0, 13, 0, 13, 0, 13, 0, 13, 0, 13, 0, 13, 0, 13, 0, 13
13, 0, 13, 0, 13, 0, 13, 0, 13, 0, 13, 0, 13, 0, 13, 0, 13, 0, 13, 0, 13, 0, 13, 0, 13, 0, 13, 0, 13, 0, 13, 0
0, 13, 0, 13, 0, 13, 0, 13, 0, 13, 5, 13, 6, 13, 0, 13, 0, 13, 0, 13, 0, 13, 0, 13, 0, 13, 0, 13, 0, 13, 0, 13
13, 0, 13, 0, 13, 0, 13, 0, 13, 0, 13, 0, 13, 0, 13, 121, 13, 122, 13, 0, 13, 0, 13, 0, 13, 0, 13, 0, 13, 0, 13, 0
0, 13, 0, 13, 0, 13, 0, 13, 0, 13, 0, 13, 0, 13, 0, 13, 0, 13, 0, 13, 0, 13, 0, 13, 0, 13, 0, 13, 0, 13, 0, 13
13, 0, 13, 0, 13, 0, 13, 0, 13, 0, 13, 0, 13, 0, 13, 0, 13, 0, 13, 0, 13, 0, 13, 0, 13, 0, 13, 0, 13, 0, 13, 0
0, 13, 0, 13, 0, 13, 0, 13, 0, 13, 0, 13, 0, 13, 0, 7|72, 0, 13, 0, 13, 0, 13, 0, 13, 0, 13, 0, 13, 0, 13, 0, 13
13, 0, 13, 0, 13, 0, 13, 0, 13, 0, 13, 0, 13, 0, 13, 0, 13, 0, 13, 0, 13, 0, 13, 0, 13, 0, 13, 0, 13, 0, 13, 0
0, 13, 0, 13, 0, 13, 0, 13, 0, 13, 0, 13, 0, 13, 0, 3, 0, 13, 0, 13, 0, 13, 0, 13, 0, 13, 0, 13, 0, 13, 0, 13
13, 0, 13, 0, 13, 0, 13, 0, 13, 0, 13, 0, 4, 0, 13, 0, 13, 0, 13, 0, 13, 0, 13, 0, 13, 0, 13, 0, 13, 0, 13, 0
0, 13, 0, 13, 0, 13, 0, 13, 0, 13, 0, 13, 0, 13, 0, 13, 0, 13, 0, 13, 0, 13, 0, 13, 0, 13, 0, 13, 0, 13, 0, 13
13, 0, 13, 0, 13, 0, 13, 0, 13, 0, 13, 0, 13, 0, 13, 0, 13, 0, 13, 0, 13, 0, 13, 0, 13, 0, 13, 0, 13, 0, 13, 0
0, 13, 0, 13, 0, 13, 0, 13, 0, 13, 0, 13, 0, 13, 0, 13, 0, 13, 0, 13, 0, 13, 0, 13, 0, 13, 0, 13, 0, 13, 0, 13
13, 0, 13, 0, 13, 0, 13, 0, 13, 0, 13, 0, 13, 0, 13, 0, 13, 0, 13, 0, 13, 0, 13, 0, 13, 0, 13, 0, 13, 0, 13, 0