8,10,10,10,10,10,10,10,10,10,10,10,10,10,10,10,10,10,10,10,10,10,11,12
25,17,18,19,19,19,19,19,19,19,19,19,19,19,19,19,19,19,19,19,19,19,17,25
42,34,62,63,89,90,91,92,62,63,71,34,34,71,28,29,85,86,87,88,28,29,34,42
42,51,79,80,106,107,108,109,79,80,71,51,51,71,45,46,102,103,104,105,45,46,51,42
42,51,71,71,71,71,71,71,71,71,71,51,51,71,71,71,71,71,71,71,71,71,51,42
42,51,71,71,13,14,15,16,71,71,71,51,51,71,71,71,13,14,15,16,71,71,51,42
42,51,4,71,30,31,32,33,71,71,4,51,51,4,71,71,30,31,32,33,71,4,51,42
42,51,6,71,47,48,49,50,71,71,6,51,51,6,71,71,47,48,49,50,71,6,51,42
42,51,2,71,64,65,66,67,71,71,2,51,51,2,71,71,64,65,66,67,71,2,51,42
42,51,71,71,81,82,83,84,71,71,71,51,51,71,71,71,81,82,83,84,71,71,51,42
42,51,71,71,98,99,100,101,71,71,71,51,51,71,71,71,98,99,100,101,71,71,51,42
42,51,71,71,115,116,117,118,71,71,71,51,51,71,71,71,115,116,117,118,71,71,51,42
42,51,71,71,71,71,71,71,71,71,71,51,51,71,121|71,71,122|71,71,71,71,71,71,51,42
42,51,71,71,71,71,71,71,71,71,71,51,51,71,71,71,71,71,71,71,71,71,51,42
42,51,71,71,13,14,15,16,71,71,71,51,51,71,71,71,13,14,15,16,71,71,51,42
42,51,71,71,30,31,32,33,71,71,71,51,51,71,71,71,30,31,32,33,71,71,51,42
42,51,4,71,47,48,49,50,71,71,4,51,51,4,71,71,47,48,49,50,71,4,51,42
42,51,6,71,64,65,66,67,71,71,6,51,51,6,71,71,64,65,66,67,71,6,51,42
42,51,2,71,81,82,83,84,71,71,2,68,68,2,71,71,81,82,83,84,71,2,51,42
42,51,71,71,98,99,100,101,71,71,71,96,97,71,71,71,98,99,100,101,71,71,51,42
42,51,71,71,115,116,117,118,71,71,71,113,114,71,71,71,115,116,117,118,71,71,51,42
42,68,71,71,71,71,71,71,71,71,71,71,71,71,71,71,71,71,71,71,71,71,68,42
59,17,18,19,19,19,19,19,19,19,19,19,19,19,19,19,19,19,19,19,19,20,17,59
76,9,10,10,10,10,10,10,10,10,10,10,10,10,10,10,10,10,10,10,10,10,11,93
